******************************************
*               ******            ***    *
*   ***   ***   ******      * B   ***    *
*   ***   ***   ******     ***           *
*   ***             *     *****   ***    *
*   *********       *     *****   ***    *
*   *******      ****      ***    ***    *
*               ******                   *
*     ***        ****       **********   *
*     ***          *       ***********   *
*     *******      *      ************   *
*     *******    ****                    *
*      A         ****               ******
******************************************