******************************************
*               ******            ***    *
*   ***   ***   ******      * B   ***    *
*   ***   ***   ******     ***           *
*   ***                   *****   ***    *
*   *********             *****   ***    *
*   *******      ****      ***    ***    *
*               ******                   *
*     ***        ****       **********   *
*     ***                  ***********   *
*     *******             ************   *
*     *******    ****                    *
*      A         ****               ******
******************************************